#####################################X##
#....................................&.#
#..........&.........G...............&.#
#..........&#########################&.#
#..........&........&.......G........&.#
#############.......&###################
#...................&..................#
#...................&..................#
#......G............&..................#
####################&#############.....#
#...................&..................#
#...................&..................#
#...................&..................#
#.....G.....&.......&...........G......#
#....#######&#######&###################
#...........&..........................#
#...........&..........................#
#...........&...............G..........#
#..#########&###################.......#
#...........&..........................#
#...........&..........................#
#...........&..........................#
#......G....&......................&...#
#.....#############################&...#
#..................................&...#
#................&.................&...#
#................&######################
#................&.....................#
#.*.........G....&.....................#
########################################
